1, 2, 3, 1, 2, 3, 1, 2, 3, 1, 1, 1, 1, 1, 1, 2, 3, 1, 2, 3, 3, 3, 3, 3, 3, 3, 3, 3, 1, 2, 3, 1, 2, 3,
35, 36, 37, 35, 36, 37, 35, 36, 37, 211, 211, 211, 211, 211, 211, 211, 211, 211, 211, 211, 211, 211, 211, 211, 211, 211, 211, 211, 35, 36, 37, 35, 36, 37,
69, 70, 71, 69, 70, 71, 69, 70, 71, 211, 7, 211, 211, 211, 7, 211, 7, 211, 7, 211, 211, 7, 211, 7, 211, 211, 7, 211, 69, 70, 71, 69, 70, 71,
215, 215, 215, 215, 215, 216, 216, 215, 215, 215, 7, 7, 215, 7, 7, 215, 7, 215, 7, 7, 216, 7, 216, 7, 7, 7, 7, 216, 215, 215, 215, 215, 216, 216,
216, 216, 216, 216, 216, 216, 216, 216, 216, 216, 7, 216, 7, 216, 7, 216, 7, 216, 7, 216, 7, 7, 216, 7, 216, 216, 7, 216, 216, 216, 216, 216, 216, 216,
215, 215, 215, 216, 216, 216, 216, 216, 216, 216, 7, 215, 215, 215, 7, 215, 7, 215, 7, 215, 215, 7, 215, 7, 215, 215, 7, 215, 215, 215, 215, 215, 215, 216,
215, 215, 215, 215, 215, 75, 215, 215, 216, 216, 216, 216, 216, 216, 211, 211, 211, 216, 216, 216, 216, 216, 216, 216, 216, 216, 216, 216, 216, 216, 216, 216, 216, 216,
215, 216, 216, 215, 5, 73, 215, 215, 215, 215, 215, 215, 215, 215, 215, 211, 211, 211, 215, 215, 215, 215, 215, 215, 215, 215, 215, 215, 7, 7, 215, 215, 215, 216,
215, 216, 5, 216, 216, 5, 216, 216, 216, 211, 211, 211, 216, 216, 137, 138, 139, 139, 216, 216, 216, 216, 216, 216, 216, 216, 216, 7, 216, 7, 216, 216, 216, 216,
215, 215, 215, 215, 215, 75, 215, 215, 215, 137, 138, 139, 139, 215, 215, 215, 215, 215, 215, 211, 215, 215, 215, 215, 138, 139, 215, 215, 215, 7, 215, 215, 215, 216,
7, 7, 7, 7, 7, 7, 7, 216, 216, 216, 216, 216, 216, 216, 216, 216, 211, 216, 216, 216, 216, 216, 216, 216, 216, 215, 7, 215, 215, 7, 7, 7, 7, 7,
215, 216, 216, 215, 215, 215, 75, 215, 215, 215, 215, 215, 215, 211, 215, 215, 215, 215, 211, 75, 215, 215, 215, 215, 215, 215, 215, 215, 7, 215, 215, 215, 215, 216,
215, 215, 215, 215, 215, 215, 73, 215, 215, 215, 5, 5, 215, 215, 215, 215, 75, 5, 215, 215, 215, 138, 139, 215, 215, 215, 5, 211, 216, 216, 216, 216, 216, 216,
215, 216, 216, 216, 216, 216, 277, 5, 5, 216, 216, 216, 216, 75, 5, 216, 216, 216, 216, 216, 216, 215, 215, 215, 215, 215, 215, 215, 73, 215, 215, 215, 215, 216,
215, 216, 216, 216, 216, 216, 277, 216, 216, 216, 216, 216, 216, 216, 216, 216, 216, 216, 215, 215, 215, 215, 215, 211, 211, 215, 73, 216, 216, 216, 216, 216, 216, 216,
215, 215, 215, 215, 215, 215, 209, 215, 215, 215, 215, 215, 215, 215, 215, 215, 215, 215, 215, 215, 215, 215, 215, 277, 277, 215, 215, 277, 215, 215, 215, 215, 215, 216,
216, 216, 216, 216, 216, 216, 209, 216, 216, 216, 216, 216, 216, 216, 216, 216, 216, 216, 216, 216, 216, 216, 216, 216, 216, 216, 216, 216, 216, 216, 216, 216, 216, 216