1, 2, 3, 1, 2, 3, 1, 2, 3, 1, 1, 1, 1, 1, 1, 2, 3, 1, 2, 3, 3, 3, 3, 3, 3, 3, 3, 3, 1, 2, 3, 1, 2, 3,
35, 36, 37, 35, 36, 37, 35, 36, 37, 211, 211, 211, 211, 211, 211, 211, 211, 211, 211, 211, 211, 211, 211, 211, 211, 211, 211, 211, 35, 36, 37, 35, 36, 37,
69, 70, 71, 69, 70, 71, 69, 70, 71, 211, 7, 211, 211, 211, 7, 211, 7, 211, 7, 211, 211, 7, 211, 7, 211, 211, 7, 211, 69, 70, 71, 69, 70, 71,
211, 211, 211, 211, 211, 211, 211, 211, 211, 211, 7, 7, 211, 7, 7, 211, 7, 211, 7, 7, 211, 7, 211, 7, 7, 7, 7, 211, 211, 211, 211, 211, 7, 211,
211, 211, 7, 211, 211, 211, 211, 211, 211, 211, 7, 211, 7, 211, 7, 211, 7, 211, 7, 211, 7, 7, 211, 7, 211, 211, 7, 211, 211, 211, 211, 211, 7, 211,
7, 211, 211, 211, 211, 211, 211, 211, 211, 211, 7, 211, 211, 211, 7, 211, 7, 211, 7, 211, 211, 7, 211, 7, 211, 211, 7, 211, 211, 211, 211, 7, 7, 211,
211, 211, 7, 211, 211, 7, 211, 211, 211, 211, 211, 211, 211, 211, 211, 211, 211, 211, 211, 211, 211, 211, 211, 211, 211, 211, 211, 211, 211, 211, 211, 7, 7, 211,
7, 211, 211, 211, 7, 7, 211, 211, 211, 211, 211, 211, 211, 211, 211, 211, 211, 211, 211, 211, 211, 211, 211, 211, 211, 211, 211, 211, 7, 7, 211, 211, 211, 211,
211, 211, 7, 211, 211, 7, 211, 211, 211, 211, 211, 211, 211, 211, 137, 138, 139, 139, 211, 211, 211, 211, 211, 211, 211, 211, 211, 7, 211, 7, 211, 211, 211, 211,
211, 211, 211, 211, 211, 7, 211, 211, 211, 137, 138, 139, 139, 211, 211, 211, 211, 211, 211, 211, 211, 211, 211, 211, 138, 139, 211, 211, 211, 7, 211, 211, 211, 211,
7, 7, 7, 7, 7, 7, 7, 211, 211, 211, 211, 211, 211, 211, 211, 211, 211, 211, 211, 211, 211, 211, 211, 211, 211, 211, 7, 211, 211, 7, 7, 7, 7, 7,
5, 5, 5, 5, 5, 5, 75, 211, 211, 211, 211, 211, 211, 211, 211, 211, 211, 211, 211, 75, 211, 211, 211, 211, 211, 211, 211, 211, 7, 75, 73, 73, 73, 73,
73, 73, 73, 73, 73, 5, 75, 211, 211, 211, 5, 5, 211, 211, 211, 211, 75, 5, 211, 211, 211, 138, 139, 211, 211, 211, 5, 211, 211, 75, 73, 277, 277, 277,
277, 277, 277, 277, 73, 5, 75, 5, 75, 211, 211, 211, 211, 75, 5, 211, 211, 211, 211, 211, 211, 211, 211, 211, 211, 211, 211, 211, 5, 75, 73, 277, 209, 209,
249, 209, 209, 277, 73, 5, 277, 211, 211, 211, 211, 211, 211, 211, 211, 211, 211, 211, 211, 211, 211, 211, 211, 211, 211, 211, 73, 211, 211, 75, 73, 277, 209, 209,
249, 209, 209, 277, 73, 5, 209, 211, 211, 73, 211, 211, 73, 211, 211, 73, 211, 211, 73, 211, 73, 211, 211, 73, 73, 211, 211, 73, 211, 75, 73, 277, 209, 209,
249, 209, 209, 277, 73, 5, 209, 279, 279, 279, 279, 279, 279, 279, 279, 279, 279, 279, 279, 279, 279, 279, 279, 279, 279, 279, 279, 279, 279, 75, 73, 277, 209, 209