36, 36, 36, 36, 36, 36, 36, 36, 36, 36, 36, 36, 36, 36, 36, 36, 36, 36, 36, 36, 36, 36, 36, 36, 36, 36, 36, 36, 36, 36, 36, 36, 36, 36,
36, 7, 7, 7, 36, 7, 36, 36, 7, 36, 7, 7, 7, 36, 7, 7, 7, 36, 7, 7, 7, 36, 7, 36, 36, 7, 36, 36, 7, 36, 36, 7, 36, 36,
36, 36, 7, 36, 36, 7, 7, 36, 7, 36, 7, 7, 36, 36, 7, 7, 36, 36, 7, 36, 7, 36, 7, 7, 36, 7, 36, 7, 36, 7, 36, 7, 36, 36,
36, 36, 7, 36, 36, 7, 36, 7, 7, 36, 7, 36, 36, 36, 7, 36, 36, 36, 7, 7, 36, 36, 7, 36, 7, 7, 36, 7, 7, 7, 36, 7, 36, 36,
36, 7, 7, 7, 36, 7, 36, 36, 7, 36, 7, 36, 36, 36, 7, 7, 7, 36, 7, 36, 7, 36, 7, 36, 36, 7, 36, 7, 36, 7, 36, 7, 7, 36,
70, 70, 70, 70, 70, 70, 70, 70, 70, 70, 70, 70, 70, 70, 70, 70, 70, 70, 70, 70, 70, 70, 70, 70, 70, 70, 70, 70, 70, 70, 70, 70, 70, 70,
215, 216, 240, 240, 215, 216, 240, 240, 240, 7, 240, 240, 240, 215, 216, 7, 240, 240, 215, 216, 240, 7, 240, 215, 216, 240, 240, 7, 215, 216, 240, 215, 216, 7,
249, 250, 240, 240, 249, 250, 240, 240, 240, 7, 240, 240, 240, 249, 250, 7, 240, 240, 249, 250, 240, 7, 240, 249, 250, 240, 240, 7, 249, 250, 240, 249, 250, 7,
240, 240, 215, 216, 240, 240, 7, 240, 240, 215, 216, 240, 7, 240, 240, 240, 215, 216, 7, 240, 240, 215, 216, 240, 7, 240, 215, 216, 211, 211, 7, 211, 215, 216,
240, 240, 249, 250, 240, 211, 7, 211, 211, 249, 250, 211, 7, 211, 211, 211, 249, 250, 7, 211, 211, 249, 250, 211, 7, 211, 249, 250, 211, 240, 7, 211, 249, 250,
2, 2, 2, 2, 2, 2, 2, 2, 2, 2, 2, 2, 2, 2, 2, 2, 2, 2, 2, 2, 2, 2, 2, 2, 2, 2, 2, 2, 2, 2, 2, 2, 2, 2,
36, 36, 36, 36, 36, 36, 36, 36, 36, 36, 36, 36, 36, 36, 36, 36, 36, 36, 36, 36, 36, 36, 36, 36, 36, 36, 36, 36, 36, 36, 36, 36, 36, 36,
36, 36, 36, 36, 7, 7, 7, 36, 7, 36, 7, 36, 7, 36, 36, 7, 36, 7, 36, 36, 7, 36, 7, 7, 7, 36, 7, 36, 36, 36, 7, 7, 36, 36,
36, 36, 36, 36, 36, 7, 36, 36, 7, 36, 7, 36, 7, 7, 36, 7, 36, 7, 7, 36, 7, 36, 7, 7, 36, 36, 7, 36, 36, 7, 36, 36, 36, 36,
36, 36, 36, 36, 36, 7, 36, 36, 7, 36, 7, 36, 7, 36, 7, 7, 36, 7, 36, 7, 7, 36, 7, 36, 36, 36, 7, 36, 36, 36, 7, 36, 36, 36,
36, 36, 36, 36, 36, 7, 36, 36, 36, 7, 36, 36, 7, 36, 36, 7, 36, 7, 36, 36, 7, 36, 7, 7, 7, 36, 7, 7, 36, 36, 36, 7, 36, 36,
36, 36, 36, 36, 36, 36, 36, 36, 36, 36, 36, 36, 36, 36, 36, 36, 36, 36, 36, 36, 36, 36, 36, 36, 36, 36, 36, 36, 36, 7, 7, 36, 36, 36