12, 45, 46, 36, 11, 12, 36, 36, 36, 70, 70, 70, 70, 70, 70, 70, 70, 70, 70, 70, 70, 70, 70, 70, 70, 70, 70, 70, 36, 11, 12, 45, 46, 36,
46, 36, 36, 36, 45, 46, 36, 36, 37, 211, 211, 211, 211, 211, 211, 211, 211, 211, 211, 211, 211, 211, 211, 211, 211, 211, 211, 211, 35, 45, 46, 36, 36, 36,
70, 70, 70, 70, 70, 70, 70, 70, 71, 211, 7, 211, 211, 211, 7, 211, 7, 211, 7, 211, 211, 7, 211, 7, 211, 211, 7, 211, 69, 70, 70, 70, 70, 70,
211, 211, 211, 215, 216, 211, 215, 216, 211, 211, 7, 7, 211, 7, 7, 211, 7, 211, 7, 7, 211, 7, 211, 7, 7, 7, 7, 211, 215, 216, 211, 211, 7, 215,
211, 211, 7, 249, 250, 211, 249, 250, 211, 211, 7, 211, 7, 211, 7, 211, 7, 211, 7, 211, 7, 7, 211, 7, 211, 211, 7, 211, 249, 250, 211, 211, 7, 249,
211, 211, 211, 211, 211, 211, 211, 211, 211, 211, 7, 211, 211, 211, 7, 211, 7, 211, 7, 211, 211, 7, 211, 7, 211, 211, 7, 211, 211, 211, 211, 7, 7, 211,
7, 211, 211, 211, 211, 7, 211, 211, 215, 216, 211, 211, 211, 211, 211, 211, 211, 211, 211, 211, 211, 211, 211, 215, 216, 211, 211, 211, 211, 211, 211, 7, 7, 211,
211, 211, 211, 211, 7, 7, 211, 211, 249, 250, 211, 211, 211, 211, 211, 211, 211, 211, 211, 211, 215, 216, 211, 249, 250, 211, 211, 211, 7, 7, 211, 211, 211, 215,
211, 211, 7, 211, 211, 7, 211, 211, 211, 211, 211, 211, 211, 211, 7, 7, 7, 7, 211, 211, 249, 250, 211, 211, 211, 211, 211, 7, 211, 7, 211, 211, 211, 249,
211, 211, 211, 211, 211, 7, 211, 211, 211, 7, 7, 7, 7, 211, 211, 211, 211, 211, 211, 211, 211, 211, 211, 211, 7, 7, 211, 211, 211, 7, 211, 211, 211, 211,
2, 2, 2, 2, 2, 2, 3, 211, 211, 215, 216, 211, 211, 211, 211, 211, 211, 211, 211, 211, 211, 211, 211, 211, 215, 216, 7, 211, 211, 1, 2, 2, 2, 2,
36, 36, 36, 36, 11, 12, 37, 211, 211, 249, 250, 211, 211, 211, 211, 211, 211, 211, 211, 75, 211, 211, 211, 211, 249, 250, 211, 211, 211, 35, 36, 11, 12, 36,
36, 11, 12, 36, 45, 46, 37, 211, 211, 211, 5, 5, 211, 211, 211, 211, 75, 5, 211, 211, 211, 5, 5, 211, 211, 211, 211, 211, 75, 35, 36, 45, 46, 36,
36, 45, 46, 36, 36, 36, 37, 5, 75, 211, 211, 211, 211, 75, 5, 211, 211, 211, 211, 211, 211, 215, 216, 211, 211, 211, 211, 211, 211, 35, 36, 36, 36, 11,
36, 36, 36, 36, 36, 36, 37, 211, 211, 211, 211, 211, 211, 211, 211, 211, 215, 216, 211, 211, 211, 249, 250, 211, 211, 211, 73, 211, 211, 35, 36, 36, 36, 45,
12, 36, 36, 11, 12, 36, 37, 211, 211, 211, 211, 211, 211, 211, 211, 211, 249, 250, 211, 211, 211, 211, 211, 211, 211, 211, 211, 73, 211, 35, 11, 12, 36, 36,
46, 36, 36, 45, 46, 36, 37, 211, 211, 73, 211, 211, 73, 211, 211, 73, 211, 211, 73, 211, 73, 211, 211, 73, 73, 211, 211, 211, 211, 35, 45, 46, 36, 36