1, 1, 1, 1, 1, 1, 1, 1, 1, 1, 1, 1, 1, 1, 1, 2, 3, 1, 2, 3, 3, 3, 3, 3, 3, 3, 3, 3, 3, 3, 3, 3, 3, 3,
35, 35, 35, 35, 35, 35, 35, 35, 35, 35, 35, 35, 35, 35, 35, 36, 37, 35, 36, 37, 37, 37, 37, 37, 37, 37, 37, 37, 37, 37, 37, 37, 37, 37,
69, 69, 69, 69, 69, 69, 69, 69, 69, 69, 69, 69, 69, 69, 69, 70, 71, 69, 70, 71, 71, 71, 71, 71, 71, 71, 71, 71, 71, 71, 71, 71, 71, 71,
211, 211, 211, 211, 211, 211, 211, 211, 211, 211, 211, 211, 211, 211, 211, 211, 211, 211, 211, 211, 211, 211, 211, 211, 211, 211, 211, 211, 211, 211, 211, 211, 211, 211,
211, 211, 211, 211, 211, 211, 211, 211, 211, 211, 211, 211, 211, 211, 211, 211, 211, 211, 211, 211, 211, 211, 211, 211, 211, 211, 211, 211, 211, 211, 211, 211, 211, 211,
211, 211, 7, 211, 7, 211, 211, 211, 211, 211, 211, 211, 211, 211, 211, 211, 7, 7, 7, 7, 7, 7, 7, 7, 7, 7, 7, 7, 211, 211, 211, 211, 211, 211,
7, 211, 211, 211, 7, 211, 211, 211, 211, 211, 211, 211, 211, 211, 211, 7, 7, 211, 211, 211, 211, 211, 211, 211, 211, 211, 211, 211, 211, 211, 211, 211, 211, 211,
211, 211, 7, 211, 7, 211, 211, 211, 211, 211, 211, 211, 211, 211, 7, 7, 7, 211, 211, 211, 7, 211, 211, 211, 211, 211, 211, 211, 211, 211, 211, 211, 211, 211,
7, 211, 211, 211, 7, 7, 7, 7, 7, 7, 7, 7, 7, 7, 7, 7, 7, 211, 211, 211, 211, 7, 211, 211, 211, 211, 211, 211, 211, 211, 211, 211, 211, 211,
211, 211, 211, 211, 211, 211, 211, 211, 211, 211, 211, 211, 211, 211, 211, 211, 211, 211, 7, 7, 7, 7, 7, 211, 211, 211, 211, 7, 211, 211, 211, 211, 211, 211,
7, 7, 7, 211, 211, 211, 211, 211, 211, 211, 211, 211, 211, 211, 211, 211, 211, 211, 211, 211, 211, 7, 211, 211, 211, 7, 211, 211, 7, 7, 7, 7, 7, 7,
75, 75, 7, 211, 211, 211, 211, 211, 7, 7, 211, 211, 211, 211, 211, 211, 211, 211, 211, 211, 7, 211, 211, 7, 211, 211, 211, 211, 211, 211, 211, 211, 211, 7,
73, 75, 7, 211, 211, 211, 46, 211, 211, 75, 211, 7, 211, 211, 211, 211, 211, 211, 7, 211, 211, 211, 211, 7, 211, 7, 7, 211, 7, 211, 211, 211, 211, 75,
73, 75, 7, 211, 211, 211, 211, 211, 75, 75, 211, 211, 211, 7, 211, 211, 7, 211, 7, 211, 211, 7, 211, 211, 211, 211, 211, 211, 211, 211, 7, 211, 211, 75,
73, 75, 7, 7, 211, 211, 46, 211, 211, 75, 211, 211, 211, 211, 211, 7, 7, 7, 7, 211, 211, 7, 211, 211, 211, 211, 211, 211, 211, 211, 211, 211, 73, 73,
73, 75, 75, 75, 211, 211, 211, 211, 211, 75, 211, 211, 211, 211, 211, 211, 211, 75, 75, 211, 211, 211, 211, 75, 211, 211, 211, 211, 75, 75, 211, 211, 211, 73,
73, 73, 73, 73, 73, 73, 73, 73, 73, 73, 73, 73, 211, 73, 73, 73, 73, 73, 73, 73, 73, 73, 73, 73, 73, 73, 73, 73, 73, 73, 73, 73, 73, 73