12, 36, 45, 46, 11, 12, 36, 36, 36, 36, 11, 12, 36, 36, 45, 46, 36, 45, 46, 36, 36, 11, 12, 45, 46, 36, 36, 11, 12, 36, 36, 36, 45, 46,
46, 36, 36, 36, 45, 46, 36, 36, 36, 36, 45, 46, 36, 36, 36, 36, 36, 36, 36, 36, 36, 45, 46, 36, 36, 36, 36, 45, 46, 36, 36, 36, 36, 36,
70, 70, 70, 70, 70, 70, 70, 70, 70, 70, 70, 70, 70, 70, 70, 70, 70, 70, 70, 70, 70, 70, 70, 70, 70, 70, 70, 70, 70, 70, 70, 70, 70, 70,
215, 216, 211, 211, 211, 215, 216, 211, 7, 211, 211, 211, 215, 216, 211, 211, 211, 215, 216, 211, 211, 211, 211, 211, 211, 211, 211, 211, 211, 211, 211, 211, 211, 211,
249, 250, 7, 211, 211, 249, 250, 211, 7, 7, 7, 211, 249, 250, 211, 211, 211, 249, 250, 211, 211, 7, 211, 211, 7, 211, 211, 7, 211, 211, 211, 215, 216, 211,
211, 211, 215, 216, 7, 211, 211, 211, 211, 211, 211, 211, 211, 211, 211, 211, 7, 7, 7, 7, 7, 7, 7, 7, 7, 7, 7, 7, 211, 211, 211, 249, 250, 211,
7, 211, 249, 250, 7, 211, 211, 211, 7, 211, 211, 215, 216, 211, 211, 7, 7, 211, 211, 211, 211, 211, 211, 211, 211, 211, 211, 215, 216, 211, 211, 211, 211, 211,
211, 211, 211, 211, 7, 211, 211, 211, 7, 211, 211, 249, 250, 211, 7, 7, 7, 211, 211, 211, 7, 211, 211, 215, 216, 211, 211, 249, 250, 211, 211, 211, 215, 216,
211, 211, 7, 211, 7, 7, 7, 7, 7, 7, 7, 7, 211, 211, 7, 7, 7, 211, 211, 211, 211, 7, 211, 249, 250, 211, 211, 211, 211, 211, 211, 211, 249, 250,
211, 211, 211, 211, 211, 211, 211, 211, 211, 211, 211, 215, 216, 211, 211, 211, 7, 211, 7, 7, 7, 7, 7, 211, 211, 7, 211, 7, 211, 211, 211, 211, 211, 211,
2, 2, 3, 211, 215, 216, 211, 211, 211, 211, 211, 249, 250, 211, 211, 211, 7, 211, 211, 211, 211, 7, 211, 211, 211, 240, 211, 211, 1, 2, 2, 2, 2, 2,
12, 36, 37, 211, 249, 250, 211, 211, 7, 211, 211, 211, 211, 211, 215, 216, 211, 211, 211, 211, 7, 211, 211, 7, 211, 211, 211, 211, 211, 211, 211, 69, 36, 11,
46, 36, 37, 211, 211, 211, 211, 211, 211, 211, 211, 211, 240, 211, 249, 250, 7, 215, 216, 211, 211, 211, 211, 240, 211, 7, 211, 211, 7, 211, 211, 211, 35, 45,
36, 36, 37, 211, 211, 211, 211, 211, 7, 211, 215, 7, 211, 211, 211, 211, 7, 249, 250, 211, 211, 7, 211, 215, 216, 211, 211, 211, 211, 211, 7, 211, 35, 36,
36, 36, 73, 2, 3, 211, 211, 211, 7, 211, 249, 250, 211, 211, 1, 2, 2, 2, 2, 2, 2, 3, 211, 249, 250, 211, 1, 2, 2, 2, 2, 2, 36, 36,
12, 36, 11, 12, 73, 2, 2, 2, 2, 2, 3, 211, 211, 5, 35, 36, 36, 36, 11, 12, 36, 37, 211, 211, 211, 211, 35, 36, 36, 11, 12, 36, 11, 12,
46, 36, 45, 46, 36, 36, 36, 11, 11, 12, 37, 211, 211, 211, 35, 11, 12, 36, 45, 46, 36, 73, 2, 2, 2, 2, 73, 36, 36, 45, 46, 36, 45, 46