1, 1, 1, 1, 1, 1, 1, 1, 1, 1, 1, 1, 1, 1, 1, 1, 2, 3, 3, 3, 3, 3, 3, 3, 3, 3, 3, 3, 3, 3, 3, 3, 3, 3,
35, 35, 35, 35, 35, 35, 35, 35, 35, 35, 35, 35, 35, 35, 35, 35, 36, 37, 37, 37, 37, 37, 37, 37, 37, 37, 37, 37, 37, 37, 37, 37, 37, 37,
69, 69, 69, 69, 69, 69, 69, 69, 69, 69, 69, 69, 69, 69, 69, 69, 70, 71, 71, 71, 71, 71, 71, 71, 71, 71, 71, 71, 71, 71, 71, 71, 71, 71,
211, 211, 211, 211, 211, 211, 211, 211, 211, 211, 211, 211, 211, 211, 211, 211, 211, 211, 211, 211, 211, 211, 211, 211, 211, 211, 211, 211, 211, 211, 211, 211, 211, 211,
211, 211, 211, 211, 211, 211, 211, 211, 211, 211, 211, 211, 211, 211, 211, 211, 7, 211, 211, 211, 211, 211, 211, 211, 211, 211, 211, 211, 211, 211, 211, 211, 211, 211,
211, 211, 211, 211, 211, 211, 211, 211, 211, 211, 211, 211, 211, 211, 211, 7, 7, 7, 211, 7, 211, 211, 211, 211, 211, 211, 211, 211, 211, 211, 211, 211, 211, 211,
211, 211, 211, 211, 211, 211, 211, 211, 211, 211, 211, 211, 211, 7, 211, 7, 211, 7, 211, 211, 211, 211, 211, 211, 211, 211, 211, 211, 211, 211, 211, 211, 211, 211,
211, 211, 211, 211, 211, 211, 211, 211, 7, 7, 7, 211, 211, 211, 211, 7, 211, 7, 7, 211, 211, 211, 211, 211, 211, 211, 211, 211, 211, 211, 211, 211, 211, 211,
211, 211, 211, 211, 211, 211, 211, 7, 7, 211, 7, 211, 211, 211, 7, 7, 211, 7, 211, 211, 211, 211, 211, 211, 211, 211, 211, 211, 211, 211, 211, 211, 211, 211,
211, 211, 211, 211, 211, 211, 211, 7, 211, 211, 7, 7, 211, 211, 211, 7, 211, 7, 211, 7, 211, 211, 211, 211, 211, 211, 211, 211, 211, 211, 211, 211, 211, 211,
7, 211, 211, 211, 211, 211, 211, 7, 211, 211, 7, 211, 211, 7, 211, 7, 211, 7, 211, 211, 211, 211, 211, 211, 211, 211, 211, 211, 211, 7, 7, 7, 7, 7,
7, 211, 211, 211, 211, 211, 211, 7, 211, 211, 7, 211, 211, 211, 211, 7, 211, 7, 7, 211, 211, 211, 211, 12, 211, 211, 211, 211, 211, 7, 211, 211, 211, 211,
7, 211, 211, 211, 211, 211, 211, 7, 211, 211, 7, 7, 211, 211, 7, 7, 211, 7, 211, 211, 211, 211, 45, 46, 211, 211, 211, 211, 211, 7, 211, 211, 211, 211,
7, 211, 211, 211, 211, 211, 211, 7, 211, 211, 7, 211, 7, 211, 211, 7, 211, 7, 211, 211, 211, 7, 7, 7, 7, 211, 211, 211, 211, 7, 211, 211, 211, 211,
7, 211, 211, 211, 211, 211, 7, 7, 211, 211, 7, 7, 211, 211, 211, 7, 211, 7, 7, 211, 7, 7, 211, 211, 7, 211, 211, 211, 211, 7, 211, 211, 211, 211,
7, 211, 211, 211, 211, 211, 7, 211, 211, 211, 211, 7, 211, 7, 7, 7, 211, 211, 7, 7, 211, 7, 211, 211, 7, 7, 211, 211, 211, 7, 211, 211, 211, 211,
7, 7, 7, 7, 7, 7, 7, 211, 211, 211, 211, 7, 7, 7, 7, 211, 211, 211, 211, 211, 211, 211, 211, 211, 211, 7, 7, 7, 7, 7, 211, 211, 211, 211