1, 1, 1, 1, 1, 1, 1, 1, 1, 1, 1, 1, 1, 1, 1, 1, 2, 3, 3, 3, 3, 3, 3, 3, 3, 3, 3, 3, 3, 3, 3, 3, 3, 3,
35, 35, 35, 35, 35, 35, 35, 35, 35, 35, 35, 35, 35, 35, 35, 35, 36, 37, 37, 37, 37, 37, 37, 37, 37, 37, 37, 37, 37, 37, 37, 37, 37, 37,
69, 69, 69, 69, 69, 69, 69, 69, 69, 69, 69, 69, 69, 69, 69, 69, 70, 71, 71, 71, 71, 71, 71, 71, 71, 71, 71, 71, 71, 71, 71, 71, 71, 71,
211, 211, 211, 7, 211, 211, 211, 211, 211, 211, 211, 211, 211, 211, 211, 211, 211, 211, 211, 211, 211, 211, 211, 211, 211, 211, 211, 211, 211, 211, 211, 211, 211, 211,
211, 211, 211, 211, 7, 211, 211, 211, 211, 211, 211, 211, 211, 211, 211, 211, 7, 211, 211, 211, 211, 211, 211, 211, 7, 211, 7, 211, 211, 211, 211, 211, 211, 211,
211, 211, 211, 211, 211, 7, 211, 211, 211, 211, 211, 211, 211, 211, 211, 7, 7, 7, 211, 7, 211, 211, 211, 7, 75, 7, 75, 7, 211, 211, 211, 211, 211, 211,
7, 7, 7, 7, 7, 7, 7, 211, 211, 211, 211, 211, 211, 7, 211, 7, 75, 7, 211, 211, 211, 211, 7, 75, 73, 45, 73, 75, 7, 211, 211, 211, 211, 211,
211, 211, 211, 211, 211, 7, 211, 211, 7, 7, 7, 211, 211, 211, 211, 7, 75, 7, 7, 211, 211, 211, 211, 7, 75, 73, 75, 7, 211, 211, 211, 211, 211, 211,
211, 211, 211, 211, 7, 211, 211, 211, 7, 5, 7, 211, 211, 211, 7, 7, 75, 7, 211, 211, 211, 211, 211, 211, 7, 75, 7, 211, 211, 211, 211, 211, 7, 211,
211, 211, 211, 7, 211, 211, 211, 7, 5, 5, 7, 7, 211, 211, 211, 7, 75, 7, 211, 7, 211, 211, 211, 211, 211, 7, 211, 211, 211, 211, 211, 7, 7, 7,
7, 211, 211, 211, 211, 211, 7, 7, 5, 5, 7, 211, 211, 7, 211, 7, 73, 7, 211, 211, 211, 211, 211, 211, 211, 211, 211, 211, 211, 211, 7, 7, 7, 7,
7, 211, 211, 211, 211, 7, 211, 7, 11, 12, 7, 211, 211, 211, 211, 7, 73, 7, 7, 211, 211, 211, 211, 7, 211, 7, 211, 211, 211, 7, 5, 5, 5, 75,
7, 211, 211, 7, 211, 211, 211, 7, 45, 46, 7, 7, 211, 211, 7, 7, 73, 7, 211, 211, 211, 211, 7, 7, 211, 211, 211, 211, 7, 7, 5, 277, 277, 277,
7, 211, 211, 7, 7, 211, 211, 7, 73, 73, 7, 211, 7, 211, 211, 7, 73, 7, 211, 211, 211, 7, 7, 7, 211, 211, 7, 211, 211, 7, 5, 277, 209, 209,
7, 211, 211, 211, 211, 211, 7, 7, 73, 73, 7, 7, 211, 211, 211, 7, 73, 7, 7, 211, 7, 7, 75, 75, 7, 211, 211, 211, 7, 7, 75, 277, 209, 209,
7, 211, 211, 211, 211, 7, 7, 75, 279, 279, 75, 7, 211, 7, 7, 7, 73, 75, 7, 7, 75, 7, 279, 279, 7, 7, 211, 211, 211, 7, 75, 277, 279, 279,
75, 75, 75, 75, 75, 75, 75, 75, 279, 279, 75, 75, 75, 75, 75, 73, 279, 279, 279, 279, 279, 279, 279, 279, 75, 7, 7, 7, 7, 7, 75, 277, 279, 279