46, 36, 11, 12, 36, 45, 46, 45, 46, 11, 12, 36, 36, 36, 36, 11, 12, 36, 36, 36, 45, 46, 36, 11, 12, 36, 36, 45, 46, 11, 12, 36, 36, 45,
36, 36, 45, 46, 36, 36, 36, 36, 36, 45, 46, 36, 36, 36, 36, 45, 46, 36, 36, 36, 36, 36, 36, 45, 46, 36, 36, 36, 36, 45, 46, 36, 36, 36,
70, 70, 70, 70, 70, 70, 70, 70, 70, 70, 70, 70, 70, 70, 70, 70, 70, 70, 70, 70, 70, 70, 70, 70, 70, 70, 70, 70, 70, 70, 70, 70, 70, 70,
216, 211, 211, 211, 211, 211, 211, 211, 211, 211, 215, 216, 211, 211, 211, 211, 211, 211, 211, 211, 215, 216, 211, 211, 211, 211, 211, 211, 211, 215, 216, 211, 215, 216,
250, 211, 211, 211, 215, 216, 211, 211, 211, 211, 249, 250, 211, 211, 211, 211, 7, 211, 211, 211, 249, 250, 211, 211, 2, 211, 2, 211, 211, 249, 250, 211, 249, 250,
215, 216, 211, 211, 249, 250, 211, 211, 211, 211, 211, 211, 211, 211, 211, 1, 2, 3, 211, 7, 211, 211, 211, 1, 73, 2, 73, 3, 211, 211, 215, 216, 211, 215,
249, 250, 211, 211, 211, 211, 211, 211, 211, 211, 211, 211, 211, 7, 211, 35, 36, 37, 211, 211, 211, 211, 35, 73, 36, 36, 36, 73, 37, 211, 249, 250, 211, 249,
211, 211, 215, 216, 211, 211, 211, 211, 1, 2, 3, 211, 211, 211, 211, 35, 36, 37, 7, 211, 211, 211, 211, 69, 73, 36, 73, 71, 211, 211, 211, 211, 211, 211,
211, 211, 249, 250, 215, 216, 211, 211, 35, 73, 37, 211, 211, 211, 5, 69, 70, 71, 211, 211, 211, 215, 216, 211, 69, 73, 71, 211, 211, 211, 211, 211, 2, 211,
211, 211, 211, 211, 249, 250, 211, 1, 73, 36, 37, 5, 211, 211, 211, 215, 216, 7, 211, 7, 211, 249, 250, 211, 211, 70, 211, 215, 216, 211, 211, 1, 73, 3,
2, 3, 211, 211, 211, 211, 5, 73, 11, 12, 37, 211, 211, 7, 211, 249, 250, 7, 211, 211, 211, 211, 211, 211, 211, 211, 211, 249, 250, 211, 1, 73, 36, 36,
36, 37, 211, 211, 211, 5, 211, 35, 45, 46, 37, 211, 211, 211, 211, 211, 211, 7, 7, 211, 211, 211, 211, 7, 211, 7, 211, 211, 211, 1, 73, 36, 36, 36,
36, 37, 211, 7, 211, 211, 211, 35, 36, 36, 37, 5, 211, 211, 5, 1, 2, 3, 211, 215, 216, 211, 1, 5, 211, 211, 211, 211, 5, 73, 36, 36, 11, 12,
36, 37, 211, 7, 7, 211, 211, 35, 36, 36, 37, 211, 7, 215, 216, 35, 36, 37, 211, 249, 250, 1, 73, 75, 211, 211, 7, 211, 211, 35, 36, 36, 45, 46,
12, 37, 211, 211, 211, 211, 1, 73, 36, 36, 37, 3, 211, 249, 250, 35, 36, 73, 3, 211, 1, 73, 36, 73, 3, 211, 211, 211, 240, 35, 36, 11, 12, 36,
46, 37, 211, 211, 211, 1, 73, 36, 11, 12, 73, 37, 211, 1, 2, 73, 11, 12, 73, 2, 73, 36, 11, 12, 73, 3, 211, 211, 211, 35, 36, 45, 46, 36,
36, 73, 2, 2, 2, 73, 36, 36, 45, 46, 36, 73, 2, 73, 36, 36, 45, 46, 36, 36, 36, 36, 45, 46, 36, 73, 2, 2, 2, 73, 36, 36, 36, 36