11, 12, 36, 73, 70, 70, 70, 70, 70, 70, 70, 70, 70, 70, 70, 71, 215, 216, 240, 240, 249, 250, 69, 70, 70, 70, 73, 36, 11, 12, 36, 36, 45, 46,
45, 46, 36, 37, 240, 215, 216, 240, 240, 240, 240, 240, 240, 240, 240, 240, 249, 250, 240, 2, 240, 240, 240, 240, 215, 216, 69, 73, 45, 46, 11, 12, 36, 11,
36, 36, 36, 37, 240, 249, 250, 240, 240, 1, 2, 3, 240, 1, 2, 3, 240, 240, 240, 240, 240, 240, 240, 240, 249, 250, 240, 69, 73, 36, 45, 46, 36, 45,
70, 70, 70, 71, 240, 240, 240, 240, 240, 35, 36, 73, 2, 73, 36, 73, 3, 240, 240, 240, 2, 240, 1, 2, 2, 3, 240, 240, 69, 70, 70, 70, 70, 70,
215, 216, 240, 240, 240, 240, 240, 1, 2, 73, 36, 36, 36, 11, 12, 36, 37, 215, 216, 240, 240, 240, 35, 11, 12, 73, 3, 240, 240, 215, 216, 215, 216, 215,
249, 250, 240, 7, 216, 240, 7, 35, 36, 73, 70, 70, 73, 45, 46, 36, 37, 249, 250, 240, 240, 2, 35, 45, 46, 36, 73, 3, 240, 249, 250, 249, 250, 249,
240, 240, 240, 249, 250, 240, 240, 35, 36, 37, 215, 216, 35, 11, 12, 36, 37, 240, 215, 216, 240, 240, 69, 73, 36, 36, 36, 73, 3, 240, 240, 240, 240, 240,
240, 7, 240, 240, 240, 7, 240, 69, 70, 71, 249, 250, 69, 45, 46, 73, 37, 240, 249, 250, 2, 240, 240, 69, 36, 36, 11, 12, 37, 215, 216, 240, 240, 1,
240, 240, 240, 240, 240, 240, 240, 240, 240, 240, 240, 240, 240, 35, 36, 37, 240, 240, 240, 240, 240, 240, 240, 240, 69, 73, 45, 46, 37, 249, 250, 240, 1, 73,
240, 240, 240, 240, 7, 240, 240, 69, 70, 70, 70, 70, 70, 70, 70, 70, 73, 37, 240, 215, 216, 2, 240, 240, 240, 69, 73, 36, 37, 240, 240, 75, 73, 36,
240, 240, 7, 240, 240, 240, 240, 240, 240, 240, 240, 240, 240, 240, 240, 211, 211, 240, 240, 249, 250, 240, 240, 240, 215, 216, 35, 36, 37, 7, 240, 240, 35, 36,
240, 240, 240, 240, 240, 7, 240, 240, 1, 2, 2, 2, 2, 2, 2, 2, 2, 2, 3, 240, 240, 215, 216, 2, 249, 250, 35, 36, 73, 3, 240, 240, 35, 36,
7, 240, 215, 216, 240, 215, 216, 240, 240, 240, 240, 240, 240, 240, 240, 35, 36, 37, 240, 240, 240, 249, 250, 215, 216, 1, 73, 11, 12, 37, 240, 240, 35, 36,
240, 240, 249, 250, 240, 249, 250, 1, 2, 2, 2, 2, 2, 2, 2, 73, 12, 73, 2, 3, 240, 240, 240, 249, 250, 35, 36, 45, 46, 73, 2, 2, 73, 36,
240, 240, 7, 1, 2, 2, 2, 11, 12, 36, 36, 36, 11, 12, 36, 45, 46, 36, 36, 36, 2, 2, 2, 2, 2, 73, 36, 36, 36, 36, 36, 36, 36, 36,
215, 216, 240, 35, 36, 36, 36, 45, 46, 36, 36, 36, 45, 46, 36, 36, 36, 11, 12, 36, 36, 36, 11, 12, 36, 36, 36, 11, 12, 36, 36, 36, 36, 11,
249, 250, 240, 35, 36, 11, 12, 36, 36, 36, 11, 12, 36, 36, 36, 36, 36, 45, 46, 36, 36, 36, 45, 46, 36, 36, 36, 45, 46, 36, 36, 36, 36, 45